    5     1     2     6     4     3     9     7     3    -1    -2     5     8     9     6
    4     5     8     9     7     6     9     6     3    -1     0     6     8     8     7
    5     9     9     8    10     7     8     6     2    -1     1     2     8     8     8
    5     7    10     8    10     6     4     3     2     0     3     2     7     9    10
    6     9    12     8     6     5     0     4     4     4     2     2    10    12     9
    5     6     9     5     4     2    -1     2     6     6     0     3    10    10     6
    3     1     4     4     4     0    -2     1     4     7     4     2     6     7     5
    3     1     5     4     3    -1    -2     0     1     2     5     2     3     5     6
    4     0     6     8     8     2     2     2     1     2     7     5     2     5     7
    7     3     5     7     9     7     5     4     4     4     4     3     1     2     3
    5     4     3     4     6     4     2     4     4     7     8     5     2     2     4
    3     2     1     0     0    -1     1     4     8    11    10     7     4     3     4
    4    -1    -2     2     0     1     2     5     7     9     6     6     1     4     4
    1     0     0     1     0     2     4     4     6     7     1     1     1     3     3
    5     0    -1     2     3     3     3     0     4     3     0     0     2     8     5
    5    -3    -2     3     4     5     5     5     8     4     3     5     5     6     5
    5    -1    -1     3     6    10     9     8    12     7     6     7     8     8     9
    7     5     1     0     6     8     8    11    11     9    11     8     9    10    14
    8     7     4     1     5     5     5     8    11    11    14    12    11     8     9
    6     7     8     5     4     0     3     6     9     8     9    11     7     5     6
